"filename", "language", "Python", "comment", "blank", "total"
"c:\Users\theor\Desktop\chess game\Board.py", "Python", 135, 1, 18, 154
"c:\Users\theor\Desktop\chess game\Constants.py", "Python", 10, 0, 2, 12
"c:\Users\theor\Desktop\chess game\Move.py", "Python", 193, 4, 28, 225
"c:\Users\theor\Desktop\chess game\Piece.py", "Python", 105, 0, 36, 141
"c:\Users\theor\Desktop\chess game\Pieces.py", "Python", 7, 0, 5, 12
"c:\Users\theor\Desktop\chess game\board_test.py", "Python", 105, 39, 13, 157
"c:\Users\theor\Desktop\chess game\game.py", "Python", 34, 1, 9, 44
"c:\Users\theor\Desktop\chess game\main.py", "Python", 3, 0, 2, 5
"c:\Users\theor\Desktop\chess game\trash\algebraic_notation.py", "Python", 47, 4, 19, 70
"c:\Users\theor\Desktop\chess game\trash\deneme.py", "Python", 4, 0, 1, 5
"c:\Users\theor\Desktop\chess game\trash\piece_types.py", "Python", 20, 0, 4, 24
"c:\Users\theor\Desktop\chess game\trash\pieces.py", "Python", 21, 0, 2, 23
"c:\Users\theor\Desktop\chess game\utilities.py", "Python", 244, 10, 63, 317
"Total", "-", 928, 59, 202, 1189